BBBB,BBBBBBBBBBBBBBB
BBBB,BBBBBBBBBBBBBBB
BBBB,BBBBBBBBBBBBBBB
BBBB,BBBBBBBBBBBBBBB
BBBB,BBBBBBBBBBBBBBB
BBBB,BBBBBBBBBBBBBBB
BBBB,BBBBBBBBBBBBBBB
BBBB,,,,,,BBBBBBBBBB
BBBBBBBBB,BBBBBBBBBB
BBBBBBBBB,BBBBBBBBBB
BBBBBBBBB,BBBBBBBBBB
BBBBBBBBB,BBBBBBBBBB
BBBBBBBBB,BBBBBBBBBB
BBBBBBBBB,BBBBBBBBBB
BBBBBBBBB,BBBBBBBBBB