;;;;;;;;;;;;;;;;;;;;
;;;;;;;;;;;;;;;;;;;;
;;;XXX;;;;;;;;;;;;;;
;;;XXX;;;;;;;;;;;;;;
;;;XXX;;;;;;;;;;;;;;
;;;;;;;;;X;;;XXXXX;;
;;;;;;;;;X;;;;;;;;;;
;;;;;;;;;X;;;;;;;;;;
;;;;;;;;;X;;;;;;;;;;
;;;;;;;;;X;;;;;;;;;;
;;;;;;;;;X;;;;XXX;;;
;;XXXX;;;;;;;;XXX;;;
;;;;;;;;;;;;;;XXX;;;
;;;;;;;;;;;;;;;;;;;;
;;;;;;;;;;;;;;;;;;;;