,,,,,,,,,.,,,,,,,,,,
,,,,,,,,,.,,,,,,,,,,
,,,,,,,,,.,,,,,,,,,,
,,,,,,,,,.,,,,,,,,,,
,,,,,,,,,.,,,,,,,,,,
,,,,,,,,,.,,,,,,,,,,
,,,,,,,,,.,,,,,,,,,,
....................
,,,,,,,,,.,,,,,,,,,,
,,,,,,,,,.,,,,,,,,,,
,,,,,,,,,.#######,,,
,,,,,,,,,.,,,,,,,,,,
,,,,,,,,,.#####,#,,,
,,,,,,,,,.,,,,#,#,,,
,,,,,,,,,.,,,,#,#,,,