BBBBBBBBBBBBBBBBBBBB
B888888888888888888B
BBB+++BBBBBBBBBBBBBB
BBB+++BBBBBBBBBBBBBB
BBB+++BBBBBBBBBBBBBB
BBBBBBBBB+BBB+++++BB
BBBBBBBBB+BBBBBBBBBB
BBBBBBBBB+BBBBBBBBBB
BBBBBBBBB+BBBBBBBBBB
BBBBBBBBB+BBBBBBBBBB
BBBBBBBBB+BBBB+++BBB
BB++++BBBBBBBB+++BBB
BBBBBBBBBBBBBB+++BBB
BBBBBBBBBBBBBBBBBBBB
BBBBBBBBBBBBBBBBBBBB